zero="0"
one="1"
two="2"
three="3"
four="4"
five="5"
six="6"
seven="7"
eight="8"
nine="9"
true="True"
false="False"
alt="|"
assert="!"
add="+"
sub="-"
multiply="*"
left_paren="("
right_paren=")"
left_bracket="["
right_bracket="]"
popr="popr"
pushl="pushl"
pushr="pushr"
drop="drop"
swap="swap"
dup="dup"
eq="=="
compose="."
eqs="=:="
lt="<"
gt=">"
lte="<="
gte=">="
neq="!="
neqs="!:="
id="id"
is_nil="is_nil"
placeholder="_"
var="?"
io="IO"
print="print"
